"filename", "language", "TypeScript JSX", "TypeScript", "Less", "comment", "blank", "total"
"d:\vite-npm\file-manager\src\lib\api\index.ts", "TypeScript", 0, 90, 0, 0, 11, 101
"d:\vite-npm\file-manager\src\lib\command\dir\copy.ts", "TypeScript", 0, 0, 0, 0, 1, 1
"d:\vite-npm\file-manager\src\lib\command\dir\delete.ts", "TypeScript", 0, 62, 0, 0, 4, 66
"d:\vite-npm\file-manager\src\lib\command\dir\mkdir.ts", "TypeScript", 0, 8, 0, 0, 4, 12
"d:\vite-npm\file-manager\src\lib\command\dir\move.ts", "TypeScript", 0, 0, 0, 0, 1, 1
"d:\vite-npm\file-manager\src\lib\command\dir\rename.ts", "TypeScript", 0, 7, 0, 0, 2, 9
"d:\vite-npm\file-manager\src\lib\command\file\copy.ts", "TypeScript", 0, 30, 0, 0, 5, 35
"d:\vite-npm\file-manager\src\lib\command\file\delete.ts", "TypeScript", 0, 64, 0, 0, 4, 68
"d:\vite-npm\file-manager\src\lib\command\file\move.ts", "TypeScript", 0, 30, 0, 0, 5, 35
"d:\vite-npm\file-manager\src\lib\command\file\rename.ts", "TypeScript", 0, 12, 0, 0, 5, 17
"d:\vite-npm\file-manager\src\lib\command\file\upload.ts", "TypeScript", 0, 19, 0, 1, 7, 27
"d:\vite-npm\file-manager\src\lib\components\Copy.tsx", "TypeScript JSX", 23, 0, 0, 0, 2, 25
"d:\vite-npm\file-manager\src\lib\components\DirTree.tsx", "TypeScript JSX", 240, 0, 0, 0, 25, 265
"d:\vite-npm\file-manager\src\lib\components\Empty.tsx", "TypeScript JSX", 73, 0, 0, 0, 2, 75
"d:\vite-npm\file-manager\src\lib\components\FileGridCard.tsx", "TypeScript JSX", 246, 0, 0, 2, 19, 267
"d:\vite-npm\file-manager\src\lib\components\FileGridList.tsx", "TypeScript JSX", 7, 0, 0, 0, 3, 10
"d:\vite-npm\file-manager\src\lib\components\FileList.tsx", "TypeScript JSX", 25, 0, 0, 1, 5, 31
"d:\vite-npm\file-manager\src\lib\components\Move.tsx", "TypeScript JSX", 23, 0, 0, 0, 2, 25
"d:\vite-npm\file-manager\src\lib\components\Provider.tsx", "TypeScript JSX", 41, 0, 0, 0, 2, 43
"d:\vite-npm\file-manager\src\lib\components\dirIcon.tsx", "TypeScript JSX", 33, 0, 0, 0, 2, 35
"d:\vite-npm\file-manager\src\lib\enum\file-action.ts", "TypeScript", 0, 9, 0, 0, 1, 10
"d:\vite-npm\file-manager\src\lib\enum\file-status.ts", "TypeScript", 0, 7, 0, 0, 3, 10
"d:\vite-npm\file-manager\src\lib\enum\index.ts", "TypeScript", 0, 3, 0, 0, 1, 4
"d:\vite-npm\file-manager\src\lib\hooks\useChooseFile.tsx", "TypeScript JSX", 32, 0, 0, 0, 6, 38
"d:\vite-npm\file-manager\src\lib\hooks\useContextMenu.tsx", "TypeScript JSX", 52, 0, 0, 0, 9, 61
"d:\vite-npm\file-manager\src\lib\hooks\useDirRename.tsx", "TypeScript JSX", 65, 0, 0, 0, 12, 77
"d:\vite-npm\file-manager\src\lib\hooks\useDragToggle.tsx", "TypeScript JSX", 42, 0, 0, 0, 6, 48
"d:\vite-npm\file-manager\src\lib\hooks\useFileChange.tsx", "TypeScript JSX", 205, 0, 0, 0, 15, 220
"d:\vite-npm\file-manager\src\lib\hooks\useFileCutAndCopy.ts", "TypeScript", 0, 101, 0, 0, 14, 115
"d:\vite-npm\file-manager\src\lib\hooks\useFileDragIn.ts", "TypeScript", 0, 33, 0, 0, 5, 38
"d:\vite-npm\file-manager\src\lib\hooks\useFilePuIn.ts", "TypeScript", 0, 49, 0, 6, 8, 63
"d:\vite-npm\file-manager\src\lib\hooks\useFileRename.tsx", "TypeScript JSX", 69, 0, 0, 0, 8, 77
"d:\vite-npm\file-manager\src\lib\hooks\useFileSelect.ts", "TypeScript", 0, 59, 0, 0, 8, 67
"d:\vite-npm\file-manager\src\lib\hooks\useFileSelectArea.tsx", "TypeScript JSX", 148, 0, 0, 4, 18, 170
"d:\vite-npm\file-manager\src\lib\hooks\useSelectedDel.ts", "TypeScript", 0, 33, 0, 0, 3, 36
"d:\vite-npm\file-manager\src\lib\hooks\useUploadProgress.tsx", "TypeScript JSX", 19, 0, 0, 0, 2, 21
"d:\vite-npm\file-manager\src\lib\index.ts", "TypeScript", 0, 1, 0, 0, 1, 2
"d:\vite-npm\file-manager\src\lib\src\content.tsx", "TypeScript JSX", 79, 0, 0, 2, 12, 93
"d:\vite-npm\file-manager\src\lib\src\index.tsx", "TypeScript JSX", 111, 0, 0, 9, 9, 129
"d:\vite-npm\file-manager\src\lib\src\slider.tsx", "TypeScript JSX", 106, 0, 0, 0, 12, 118
"d:\vite-npm\file-manager\src\lib\src\toolbar.tsx", "TypeScript JSX", 114, 0, 0, 0, 13, 127
"d:\vite-npm\file-manager\src\lib\style\content.less", "Less", 0, 0, 112, 0, 9, 121
"d:\vite-npm\file-manager\src\lib\style\dir-tree.less", "Less", 0, 0, 49, 0, 8, 57
"d:\vite-npm\file-manager\src\lib\style\index.less", "Less", 0, 0, 97, 0, 15, 112
"d:\vite-npm\file-manager\src\lib\style\slider.less", "Less", 0, 0, 6, 0, 0, 6
"d:\vite-npm\file-manager\src\lib\style\toobar.less", "Less", 0, 0, 9, 0, 2, 11
"d:\vite-npm\file-manager\src\lib\types\drag.ts", "TypeScript", 0, 6, 0, 0, 4, 10
"d:\vite-npm\file-manager\src\lib\types\index.ts", "TypeScript", 0, 64, 0, 0, 8, 72
"d:\vite-npm\file-manager\src\lib\utils\area.ts", "TypeScript", 0, 11, 0, 5, 6, 22
"d:\vite-npm\file-manager\src\lib\utils\axios.ts", "TypeScript", 0, 34, 0, 2, 8, 44
"d:\vite-npm\file-manager\src\lib\utils\context.ts", "TypeScript", 0, 13, 0, 0, 4, 17
"d:\vite-npm\file-manager\src\lib\utils\contextmenuOption.ts", "TypeScript", 0, 43, 0, 0, 2, 45
"d:\vite-npm\file-manager\src\lib\utils\date.ts", "TypeScript", 0, 7, 0, 0, 2, 9
"d:\vite-npm\file-manager\src\lib\utils\event.ts", "TypeScript", 0, 34, 0, 0, 7, 41
"d:\vite-npm\file-manager\src\lib\utils\extension.ts", "TypeScript", 0, 9, 0, 0, 2, 11
"d:\vite-npm\file-manager\src\lib\utils\icon.ts", "TypeScript", 0, 13, 0, 0, 2, 15
"d:\vite-npm\file-manager\src\lib\utils\minetype.ts", "TypeScript", 0, 3, 0, 0, 1, 4
"d:\vite-npm\file-manager\src\lib\utils\pub-sub.ts", "TypeScript", 0, 96, 0, 4, 13, 113
"d:\vite-npm\file-manager\src\lib\utils\resize.ts", "TypeScript", 0, 26, 0, 0, 2, 28
"d:\vite-npm\file-manager\src\lib\utils\size.ts", "TypeScript", 0, 8, 0, 0, 4, 12
"d:\vite-npm\file-manager\src\lib\utils\uid.ts", "TypeScript", 0, 5, 0, 0, 1, 6
"Total", "-", 1753, 989, 273, 36, 377, 3428